P01V01R01
P01V01R02
P01V01R03
P01V01R04
P01V01R05
P01V01R06
P01V01R07
P01V01R08
P01V01R09
P01V01R10
P01V01R11
P01V01R12
P01V01R13
P01V01R14
P01V01R15
P01V02R01
P01V02R02
P01V02R03
P01V02R04
P01V02R05
P01V02R06
P01V02R07
P01V02R08
P01V02R09
P01V02R10
P01V02R11
P01V02R12
P01V02R13
P01V02R14
P01V02R15
P01V03R01
P01V03R02
P01V03R03
P01V03R04
P01V03R05
P01V03R06
P01V03R07
P01V03R08
P01V03R09
P01V03R10
P01V03R11
P01V03R12
P01V03R13
P01V03R14
P01V03R15
P01V04R01
P01V04R02
P01V04R03
P01V04R04
P01V04R05
P01V04R06
P01V04R07
P01V04R08
P01V04R09
P01V04R10
P01V04R11
P01V04R12
P01V04R13
P01V04R14
P01V04R15
P01V05R01
P01V05R02
P01V05R03
P01V05R04
P01V05R05
P01V05R06
P01V05R07
P01V05R08
P01V05R09
P01V05R10
P01V05R11
P01V05R12
P01V05R13
P01V05R14
P01V05R15
P02V01R01
P02V01R02
P02V01R03
P02V01R04
P02V01R05
P02V01R06
P02V01R07
P02V01R08
P02V01R09
P02V01R10
P02V01R11
P02V01R12
P02V01R13
P02V01R14
P02V01R15
P02V02R01
P02V02R02
P02V02R03
P02V02R04
P02V02R05
P02V02R06
P02V02R07
P02V02R08
P02V02R09
P02V02R10
P02V02R11
P02V02R12
P02V02R13
P02V02R14
P02V02R15
P02V03R01
P02V03R02
P02V03R03
P02V03R04
P02V03R05
P02V03R06
P02V03R07
P02V03R08
P02V03R09
P02V03R10
P02V03R11
P02V03R12
P02V03R13
P02V03R14
P02V03R15
P02V04R01
P02V04R02
P02V04R03
P02V04R04
P02V04R05
P02V04R06
P02V04R07
P02V04R08
P02V04R09
P02V04R10
P02V04R11
P02V04R12
P02V04R13
P02V04R14
P02V04R15
P02V05R01
P02V05R02
P02V05R03
P02V05R04
P02V05R05
P02V05R06
P02V05R07
P02V05R08
P02V05R09
P02V05R10
P02V05R11
P02V05R12
P02V05R13
P02V05R14
P02V05R15
P03V01R01
P03V01R02
P03V01R03
P03V01R04
P03V01R05
P03V01R06
P03V01R07
P03V01R08
P03V01R09
P03V01R10
P03V01R11
P03V01R12
P03V01R13
P03V01R14
P03V01R15
P03V02R01
P03V02R02
P03V02R03
P03V02R04
P03V02R05
P03V02R06
P03V02R07
P03V02R08
P03V02R09
P03V02R10
P03V02R11
P03V02R12
P03V02R13
P03V02R14
P03V02R15
P03V03R01
P03V03R02
P03V03R03
P03V03R04
P03V03R05
P03V03R06
P03V03R07
P03V03R08
P03V03R09
P03V03R10
P03V03R11
P03V03R12
P03V03R13
P03V03R14
P03V03R15
P03V04R01
P03V04R02
P03V04R03
P03V04R04
P03V04R05
P03V04R06
P03V04R07
P03V04R08
P03V04R09
P03V04R10
P03V04R11
P03V04R12
P03V04R13
P03V04R14
P03V04R15
P03V05R01
P03V05R02
P03V05R03
P03V05R04
P03V05R05
P03V05R06
P03V05R07
P03V05R08
P03V05R09
P03V05R10
P03V05R11
P03V05R12
P03V05R13
P03V05R14
P03V05R15